14792098
14792099
14792100
14792101
14792102
14792103
14792104
14792105
14792106
14844544
14844545
14844546
14844547
14844548
14844549
14844550
14844551
14844552
14844553
14844554
14844555
14844556
14844557
14844558
14844560
14844561
14844562
14844563
14844564
14844565
14844566
14844567
14844568
14844569
14844570
14844571
14844572
14856636
.SH AUTHOR
Written by Kevin Day.
.SH COPYRIGHT
.PP
Copyright \(co 2007-2023 Kevin Day, GNU LGPL Version 2.1 or later.
