32
49824
14785152
14844032
14844033
14844034
14844035
14844036
14844037
14844038
14844039
14844040
14844041
14844042
14844079
14844319
14909568
